R 1600 900
NO ./wall/2/face_a-2.xpm
SO ./wall/2/face_a-2.xpm
WE ./wall/1/face_c.xpm
EA ./wall/2/face_c-2.xpm
S ./square.xpm
F 120,120,120
C 47,79,79

11111111111111111111111111111  111
1000000000110000000000100000111101
1011000001110000000000101000000001
10010000000000000000001010N0111111
10110000011100000000000000001
10000000001100000111011110001
111101111111110111000000100011111
111101111111110111010100100011111
11000000110101011100000010001
10000000000000001100000010001
10000000000000001101010010201
11000000110101011111011110001
11110111111101011111011110001
11111111111111111111111111111
