R 1600 900
NO ./pics/mossy.xpm
SO ./pics/redbrick.xpm
WE ./pics/eagle.xpm
EA ./pics/greystone.xpm
S ./pics/barrel.xpm
I ./pics/purplestone.xpm
F 120,120,120
C 47,79,79

11111111111111111111111111111  111
10000000001100000000001002S2111101
1011000001110000000000101222300001
1001000000000000000000101222111111
10110000011100000000000022221
10000000001100000111011112221
111101111111110111000000122211111
111101111111110111010100122211111
11000000110101011100000012221
10000000000000001100000012221
10000000000000001101010012221
11000000110101011111011112221
11110111111101011111011112221
11111111111111111111111112221
                        12221
                        12221
                        12221
                        12221
                        11111