R 1600 900
NO ./pics/mossy.xpm
SO ./pics/redbrick.xpm
WE ./pics/eagle.xpm
EA ./pics/greystone.xpm
S ./pics/pillar.xpm
I ./pics/purplestone.xpm
F 120,120,120
C 47,79,79

11111111111111111111111111111  111
1000000000110000000000100222111101
1011000001110000000000101202300001
10010000000000000000001012S2111111
10110000011100000000000022021
10000000001100000111011112021
111101111111110111000000120211111
111101111111110111010100120211111
11000000110101011100000012021
10000000000000001100000012021
10000000000000001101010012021
11000000110101011111011112021
11110111111101011111011112221
11111111111111111111111111111
